454545454545454545454545454545454545454545454545454545454545454545454545454545454545450
000000000000000000000000000000000000000000000000000000000000000000000000000000000000555
000000000000000000000000000000000000000000000000000000000000000000000000000000000000555
000000000000000000000000000000000000000000000000000000000000000000000000000000000000555
000000000000000000000000000000000000000000000000000000000000000000000000000000000000005
000000000000000000000000000000000000000000000000000000000000000000000000000000000000005
000000000000000000000000000000000000000000000000000000000000000000000000000000000000005
000000000000000000000000000000000000000000000000000000000000000000000000000000000000005
000000000000000000000000000000000000000000000000000000000000400000000000000000000000005
345454545454545454545454545454545454545454545454545454545454500000454545454545454545450