000000000000000000000000000000
000000000000000000000000000000
000000000000022200000000000000
000000000000000100000000000000
220000022200000000000000000000
112222211122000000000000000000
111111111111220002200000002000
111111111111112221100002221200
111111111111111111100001111100
111111111111111111100000110000
111111111111111111100000100000
111111111111111111100000100000
111111111111111111100000000000