000000000000000000000000000000
000000000000000000000000000000
000000000000022200000000000000
000000000000000100000000000000
000000000000000000000002221200
000000000000000000000000000000
000000000000000000000000000000
000000000000000000000000000000
222222222222222222200001111100
111111111111111111100000110000
111111111111111111100000100000
111111111111111111100000100000
111111111111111111100000000000