000000000000000000000000000000
000000000000000000000000000000
000000000000022200000000000000
000000000000000100000000000000
220000022222000000000000000000
112220211111000000000000000000
111111111100000002200000022000
111111111122222221100002211200
111111111111111111100001111100
111111111111111111100000110000
111111111111111111100000100000
111111111111111111100000100000
111111111111111111100000000000