000000000000000000000000000000
000000000000000000000000000000
000000000000022220000000000000
000000000000011110000000000000
000000000000000100000000000000
000000000000000000000000000000
000000000000000000000000000000
000000000000000000000000000000
000000000000000000000000000000
222222222222222222222220222000
111111111111111111111100110000
111111111111111111111000100000
111111111111111111110000000000