000000000000000000000000000000
000000000000000000000000000000
000000000000000000000000000000
000000000000000000000000000000
000000000000000000000000000000
000000000000000000000000000000
000000000000000000000000000000
000000000000000000000000000000
000000000000000000000000000000
345454545454545454540000222000
222222222222222222220000110000
222222222222222222221000100000
222222222222222222220000000000