000000000000000000000000000000
000000000000000000000000000000
000000000000022200000000000000
000000000000000100000000000000
200000022222000000000000000000
100000000000000000000000000000
120000000000000002200000022000
112222222222222221100002211200
111111111111111111100001111100
111111111111111111100000110000
111111111111111111100000100000
111111111111111111100000100000
111111111111111111100000000000